16
128
128
128
-5 -5 -5 -5 -5 -5 -5 -5
-5 5 7 9 7 6 3 -5
-5 4 -15 10 7 -5 0 -5
-5 2 4 6 5 6 4 -5
-5 0 -5 3 -10 2 2 -5
-5 -3 0 0 0 0 0 -5
-5 -5 -2 -3 -4 -3 -2 -5
-5 -5 -5 -5 -5 -5 -5 -5